1111111111111111111111111
1C1C1C1C111111111C1C1C1C1
1C1C1C1CCCCCCCCCCC1C1CCC1
1PCCCCCCCCCCCCCCCCCCCCCE1
1C1C1C1CCCCCCCCCCC1C1CCC1
1C1C1C1C111111111C1C1C1C1
1111111111111111111111111