1111111111
1C00P000C1
1001001001
1001001001
1C000000E1
1111111111