1111111111111
10P0000000001
10C0000000001
1000000000001
1000000000001
1000000000001
1000000000E01
1111111111111