111111111111111111111
10P00N0000000000C0001
10C00N0000000C00C0001
1000000000000C00C0001
100000000N000C00C0001
10000N0000000C00C0001
10000N0000E00C00C0001
111111111111111111111