111111111111
1P0000000001
1CC0000CC001
1CCCCCCCCCC1
100CCCCC0001
100CCNNC0001
100CCNNC0001
100CCCCC0001
100CCNNC0001
100CCCCC0001
100CCNNC00E1
111111111111